11111
1P0E1
10CC1
10001
11111
